5,9,1,4;24,19,14,9,4,3,2;5,10,11;8,13,18,23,22,21,20;0,1,6,7,12,17,16,15
5,9,5,4;10,5,0;24,19,14,9,4,3,2,1,6,11;15,20,21,22,23,18,13,8;7,12,17,16
5,11,1,4;13,18,17;8,7,6,5,10;15,20,21,22,23,24,19,14,9,4,3,2,1,0;16,11,12
5,11,2,4;24,23,18,17,12;5,10,15,20;0,1,2,3,4,9,14,19;13,8,7,6,11,16,21,22
5,11,3,4;17,16,11,6;7,12,13,18,23,22,21,20,15,10,5,0;8,9,14,19,24;1,2,3,4
5,11,4,5;23,22,21,16,11,6;20,15,10,5,0,1,2,3,8;7,12,17;18,19,24;4,9,14,13
5,11,5,4;17,12,11;16,15,10,5,0;6,7,8,13,18,23,22,21,20;1,2,3,4,9,14,19,24
5,11,6,4;15,20,21;18,13,8,3,2,1,0,5,10,11;16,17,22,23,24,19,14,9,4;12,7,6
5,11,7,5;14,19,24,23,22,21;0,5,6,7,12,17,16;1,2,3,4;20,15,10,11;9,8,13,18
5,11,8,4;0,5,6,11,16;23,24,19,14,9;18,13,8,3,4;10,15,20,21,22,17,12,7,2,1
5,11,9,4;0,1,2,3,4,9,14,19,24,23,22;13,12,11,10,15,20,21;5,6,7,8;18,17,16
5,11,10,3;24,23,18,13,8,7,6,11,16,15;19,14,9,4,3,2,1,0,5,10;20,21,22,17,12
5,16,1,3;17,18,13,8,7,6,5,0;1,2,3,4,9,14,19,24,23,22,21,16;20,15,10,11,12
5,16,9,4;12,7,6;18,17,16,11,10;15,20,21,22,23,24,19,14,9,4;13,8,3,2,1,0,5
5,17,5,4;14,13,18,17,16,11,6;21,22,23,24,19;20,15,10,5,0,1,2,3,4,9;8,7,12
5,24,1,4;18,17,16,11,6;2,1,0,5,10,15,20,21,22,23,24,19;4,3,8;9,14,13,12,7
5,24,4,4;24,19,14,9,8;4,3,2,7,12,17;13,18,23,22,21,20,15,10,5,0,1;16,11,6
5,24,7,5;1,2,7,8,13;3,4,9,14,19,24,23,22;12,11,6;18,17,16,21,20;15,10,5,0
5,24,10,4;20,21,22,23,24,19,14,9,4,3,2,1,0,5,10;13,12,11;6,7,8;18,17,16,15
5,27,1,5;5,10,11,12,13,18;4,3,2;15,16,17;19,24,23,22,21,20;0,1,6,7,8,9,14
5,27,2,5;4,3,2,1,6;15,20,21,22,23;0,5,10,11,16;9,8,7,12,17,18;24,19,14,13
5,28,1,4;6,7,8,3;11,12,13,14,9,4;24,19,18,17,16;23,22,21,20,15,10,5,0,1,2
5,28,2,5;16,17,18;3,2,1,0,5;4,9,8;13,12,7;6,11,10,15,20,21,22,23,24,19,14
5,29,7,5;18,13,8,3,4;9,14,19,24,23,22;20,15,10,11,6;5,0,1,2;7,12,17,16,21
5,29,8,4;13,8,3,4;2,1,0,5,10,15,20,21,22,23,24;9,14,19,18,17,12,7;6,11,16
5,29,9,5;4,9,14,19,24,23,22;16,11,6;3,8,13;0,1,2,7,12,17,18;21,20,15,10,5
5,29,10,5;24,19,14,9,8,7;4,3,2;1,6,11,16,17,22;0,5,10,15,20,21;23,18,13,12
5,31,2,4;20,21,16,17,18;4,3,2,1,0;15,10,11,12,13;22,23,24,19,14,9,8,7,6,5
5,31,5,4;24,23,22,21,20,15,10,5,0,1,2,3,4;12,13,8;17,16,11,6,7;9,14,19,18
5,36,3,4;16,11,12;4,9,14,19,24,23;0,1,2,3,8,13,18,17,22;21,20,15,10,5,6,7
5,37,1,4;18,13,8,3;1,6,11;0,5,10,15,20,21,22,23,24,19,14,9,4;2,7,12,17,16
5,50,1,5;11,16,17,18;10,15,20,21,22,23,24,19,14,13,8;6,7,12;1,0,5;9,4,3,2
5,50,5,3;15,10,11,12;20,21,16,17,18,13,8,7,6,5,0;22,23,24,19,14,9,4,3,2,1
5,52,1,4;23,24,19,14,9,4,3,2,7,12,17;8,13,18;16,11,6,1;0,5,10,15,20,21,22
5,52,2,4;0,5,10,15,20,21,22,23,24,19,14;18,17,16,11,6,1;13,8,9,4;12,7,2,3
5,56,6,5;6,11,16;9,4,3,2,1,0,5,10,15,20;19,14,13,8;21,22,23,24;7,12,17,18
5,57,1,4;17,22,23,24;18,13,12,11,16;4,3,2,1,0,5,10,15,20,21;19,14,9,8,7,6
5,57,9,4;12,7,8;19,24,23,22,21,20,15,10;5,0,1,2,3,4,9,14,13;18,17,16,11,6
5,58,1,5;19,24,23,22,21,20;3,4,9,14;12,11,6;10,5,0,1;2,7,8,13,18,17,16,15
5,60,1,4;22,23,18,13,8;20,15,10,5,0,1,2,3,4,9,14,19,24;7,6,11;21,16,17,12
5,60,4,4;8,13,18,23,22,21,20,15,10,5,0;17,12,7;2,3,4,9,14,19,24;16,11,6,1
5,60,7,4;13,18,17,22,21,20;6,7,8;16,11,12;23,24,19,14,9,4,3,2,1,0,5,10,15
5,60,10,3;8,13,18,17,16,15,10,5,0,1;20,21,22,23,24,19,14,9,4,3,2,7;6,11,12
5,78,1,4;20,21,22;18,17,12,11;23,24,19,14,9,4,3,2,1,0;16,15,10,5,6,7,8,13
5,79,1,4;6,7,12,13;14,19,24,23,22,21,20,15,10,5,0,1,2,3;4,9,8;18,17,16,11
5,79,3,4;8,13,18,23;22,17,12,7;24,19,14,9,4,3,2,1,0,5,10,15,20;21,16,11,6
5,79,5,5;20,21,22,23,24,19,14;4,3,2,7;9,8,13,12,11,6;1,0,5,10;18,17,16,15
5,79,7,4;13,12,7;18,19,14,9,4;21,20,15,10,5,0,1,2,3,8;6,11,16,17,22,23,24
5,79,9,4;21,22,23,24,19,14,9,4,3,2;20,15,16;1,6,7,8,13,18;0,5,10,11,12,17
5,79,11,5;10,11,12;24,23,22,17,16;21,20,15;5,0,1,2,3,4,9,14;6,7,8,13,18,19
5,84,1,4;11,12,13,14;19,24,23,22,21,20,15,10,5,0,1,2,3,4;9,8,7,6;16,17,18
5,84,2,4;19,24,23,22,21,20;6,7,8;5,0,1,2,3,4,9,14,13,12,11;18,17,16,15,10
5,0,1,5;21,16,17,18,19,14,9,8,7,6,5;10,15,20;13,12,11;22,23,24;0,1,2,3,4
5,0,2,4;7,6,5,10,15,20;4,9,14,19,24,23;0,1,2,3,8,13,18,17,22;21,16,11,12
5,0,3,4;24,23,22;16,11,6;3,8,13;4,9,14,19,18,17,12,7,2,1,0,5,10,15,20,21
5,0,4,3;0,5,10,15,20,21,22,23,24,19,14;9,4,3,2,7,12;1,6,11,16,17,18,13,8
5,0,5,5;4,3,2,1,0;5,6,7;9,8,13,12,11,10,15,20;16,21,22,23,24;17,18,19,14
5,0,6,4;18,17,16,15,10,5,0;1,2,3,4,9,14,19,24,23,22,21,20;7,8,13;6,11,12
5,0,7,5;7,2,1;10,15,16,17,18,13,8;12,11,6,5,0;23,22,21,20;3,4,9,14,19,24
5,0,8,4;8,9,14;23,22,21,20,15,10,5,0,1,2,3,4;17,16,11,6,7;12,13,18,19,24
5,0,9,4;22,21,20,15,10,5,0;24,19,14,9,4,3,2,7,12;8,13,18,23;17,16,11,6,1
5,0,10,5;14,19,24,23,22,21,20,15;4,9,8,13,18;16,11,10,5;17,12,7,2,3;6,1,0
5,0,11,4;0,1,2,3,4,9,14,19,24;12,17,16;23,22,21,20,15,10,5;11,6,7,8,13,18
5,0,12,5;23,18,13,8,3;12,17,22,21,20,15;24,19,14,9,4;7,2,1,0,5,10;6,11,16
5,0,13,4;0,5,10,15;24,23,18,13,8;19,14,9,4,3,2,7,12,17,22;1,6,11,16,21,20
5,0,14,4;14,9,4,3,2,7,12,17;1,0,5,10,15,20,21,22,23,24,19;6,11,16;18,13,8
5,0,15,5;6,7,8,9;19,14,13;4,3,2,1,0,5,10,15,20;24,23,18,17,12,11;16,21,22
5,0,16,5;16,15,10,5,0;2,7,12,17;20,21,22,23,24,19,14,9;4,3,8,13,18;1,6,11
5,0,17,5;6,11,12;16,17,22,23;13,8,7,2,1,0,5,10,15,20,21;24,19,18;14,9,4,3
5,0,18,4;24,19,18,17,16,11,6;23,22,21,20,15,10,5,0,1,2,7;8,3,4;12,13,14,9
5,0,19,3;5,10,15,20,21,22,23,24,19,14,13,8;0,1,6,11,16,17,18;9,4,3,2,7,12
5,0,20,5;3,8,13,18,23,22,21,16,11,6;20,15,10;7,12,17;5,0,1,2;4,9,14,19,24
5,0,21,5;12,13,18;1,6,11,16,17;4,3,2;0,5,10,15,20,21,22,23;24,19,14,9,8,7
5,0,22,5;21,22,23,24,19;13,14,9,4;0,5,10,11,12,7,8;18,17,16,15,20;3,2,1,6
5,0,23,3;23,18,13,8,7,6,11,16;12,17,22,21,20,15;24,19,14,9,4,3,2,1,0,5,10
5,0,24,4;9,4,3,2,1;10,15,20,21,22,23,24,19;8,7,12;0,5,6,11,16,17,18,13,14
5,0,25,4;8,7,6,11,16;2,3,4,9,14,13;19,18,17,12;1,0,5,10,15,20,21,22,23,24
5,0,26,4;12,11,6,1,2,3,4,9,14;16,17,18,19;0,5,10,15,20,21,22,23,24;7,8,13
5,0,27,4;6,11,16;22,17,18,13,8,3,4;12,7,2,1,0,5,10,15,20,21;23,24,19,14,9
5,0,28,4;8,13,18,23,22,21,16,11,6;17,12,7;20,15,10,5,0,1,2;3,4,9,14,19,24
5,0,29,4;7,12,11,10,15;20,21,22,23,24,19,14,9,4,3,2,1;8,13,18,17,16;0,5,6
5,0,30,4;0,5,10,15,20;7,12,17,18,23;24,19,14,9,4;13,8,3,2,1,6,11,16,21,22
5,0,1,4;0,1,6,11,16;23,24,19,14,9,4;3,2,7,12,17,22,21,20,15,10,5;18,13,8
5,0,9,4;4,3,8,7,6,11,16;2,1,0,5,10,15,20,21,22,23,24;17,18,19;12,13,14,9
5,0,17,4;8,13,12;7,6,11,16,17,18,23;24,19,14;9,4,3,2,1,0,5,10,15,20,21,22
5,0,25,4;21,22,23,18,13,8,3,2,1,0,5,10,11;16,15,20;17,12,7,6;24,19,14,9,4
5,0,33,5;20,21,22,17,12;4,9,14,19,24,23;18,13,8,3;7,6,11,16;2,1,0,5,10,15
5,0,41,4;18,17,22,21,20,15,10,5,0,1,2,3;16,11,12;4,9,14,19,24,23;6,7,8,13
5,0,49,4;4,3,2,1;13,18,17,16;12,11,10,15,20,21,22,23,24,19,14;0,5,6,7,8,9
5,0,57,3;1,2,3,4,9,14,13,12,11,10,15,20,21,22,23;8,7,6,5,0;24,19,18,17,16
5,0,65,4;20,15,16,17,18;5,10,11,12,13;4,3,2;21,22,23,24,19,14,9,8,7,6,1,0
5,0,73,4;2,3,8,13,12,11;1,6,7;4,9,14,19,18,17,16;0,5,10,15,20,21,22,23,24
5,0,81,5;8,13,12,17,16,15,20;7,6,11,10;24,19,14,9;4,3,2,1,0,5;21,22,23,18
5,0,89,4;6,11,16,21;4,3,2,1,0,5,10,15,20;9,8,7,12,17,22,23,24,19;18,13,14
5,0,97,5;16,11,6,1,2,3,8;24,19,18;21,20,15,10,5,0;4,9,14,13;23,22,17,12,7
5,0,105,4;19,14,9,8,7,12;4,3,2,1,6,11,16;13,18,23,24;17,22,21,20,15,10,5,0
5,0,113,5;6,5,10,15,20,21;4,3,2,1,0;11,16,17,22;23,18,13,12,7;24,19,14,9,8
5,0,1,5;18,17,12;21,16,11,6;3,4,9;0,1,2,7,8,13,14,19,24,23,22;20,15,10,5
5,0,2,4;24,19,18,17;12,13,14,9,4,3,2,1,0;8,7,6,5,10,15,20;11,16,21,22,23
5,0,3,4;21,20,15,10,5,0,1,2,7;8,13,12,17,22,23,24;16,11,6;3,4,9,14,19,18
5,0,4,4;9,4,3,2,1,0,5,10,11,12;18,17,16,15,20;6,7,8,13,14,19,24;23,22,21
5,0,5,5;24,19,14;13,18,23,22,21;20,15,16,17,12,7,8,9;6,11,10;4,3,2,1,0,5
5,0,6,5;23,18,13,12,7,2,1,0,5;10,15,20,21,22;6,11,16,17;8,3,4;24,19,14,9
5,0,7,5;12,11,6;2,3,4,9,14,19,18,17,16;24,23,22,21;7,8,13;20,15,10,5,0,1
5,0,8,4;6,11,12;7,8,13,18,17;23,22,21,20;16,15,10,5,0,1,2,3,4,9,14,19,24
5,0,9,4;21,22,17,18,13,8;6,5,10,15,20;7,12,11,16;23,24,19,14,9,4,3,2,1,0
5,0,10,5;24,19,18,13,12,7,6,1;0,5,10,11,16,17;14,9,8;23,22,21,20,15;2,3,4
5,0,11,5;9,14,19,24;23,18,13,12,7,2;16,11,6;8,3,4;1,0,5,10,15,20,21,22,17
5,0,12,3;15,20,21,22,23,24,19,14,9,4,3,2,1,0;12,7,6;5,10,11,16,17,18,13,8
5,0,13,4;8,3,2;13,12,7,6,1,0;15,20,21,22,23,24;5,10,11,16,17,18,19,14,9,4
5,0,14,4;16,11,12,13;6,7,8,9,14,19,24;23,18,17;22,21,20,15,10,5,0,1,2,3,4
5,0,15,4;24,23,22,21,20,15,10,5,0,1,2,7,8;3,4,9;14,19,18,17,16;13,12,11,6
5,0,16,3;8,7,6,11,16,17,22,23,24,19;18,13,12;14,9,4,3,2,1,0,5,10,15,20,21
5,0,17,5;24,19,18,17,16,11,10;5,0,1,2,3,4;12,13,14,9;23,22,21,20,15;6,7,8
5,0,18,4;7,6,11,16,21;4,3,8,13,12,17,22,23,24;20,15,10,5,0,1,2;18,19,14,9
5,0,19,4;4,3,8,13,18,17;10,15,20;6,5,0;9,14,19,24,23,22,21,16,11,12,7,2,1
5,0,20,5;11,12,7;8,9,14,19,24,23,22,21;6,5,10,15,20;4,3,2,1,0;16,17,18,13
5,0,21,4;14,9,4,3;0,1,2,7,12,11;16,17,18,13,8;6,5,10,15,20,21,22,23,24,19
5,0,22,4;16,17,18,13,14,9,4,3;8,7,12,11;6,5,10,15,20,21,22,23,24,19;2,1,0
5,0,23,6;8,7,6;2,1,0,5;10,15,20,21;18,13,12,11;9,4,3;16,17,22,23,24,19,14
5,0,24,5;24,19,14,9;11,12,13,18;21,20,15,10,5,6,7,8,3,4;16,17,22,23;0,1,2
5,0,25,4;19,18,17,16;5,0,1,2,3;6,7,8;4,9,14,13,12,11,10,15,20,21,22,23,24
5,0,26,6;4,3,2;0,1,6,11,12,17;7,8,9;5,10,15,20;16,21,22,23,18;24,19,14,13
5,0,27,5;0,5,6;10,15,20,21;12,11,16;22,23,24,19,14,9,4,3;1,2,7,8,13,18,17
5,0,28,4;8,7,12;13,14,19,24;23,18,17,16,11,6;22,21,20,15,10,5,0,1,2,3,4,9
5,0,29,6;4,9,8;16,15,10,5,0;17,12,11,6,1;24,19,14,13;3,2,7;18,23,22,21,20
5,0,30,5;22,17,18,13,14,9,4,3,2,1,0;20,15,10,5,6;8,7,12;11,16,21;23,24,19
5,0,31,4;20,15,16,17,18,13,8,3,2;21,22,23,24,19,14,9,4;1,0,5,10,11;12,7,6
5,0,32,4;6,1,0;11,12,7,2;8,13,18,17,16,15,10,5;3,4,9,14,19,24,23,22,21,20
5,0,33,5;13,14,19;6,1,2,3,4;24,23,18,17,16,15,10,5,0;11,12,7,8,9;22,21,20
5,0,34,4;18,17,16,11,10,5,0,1,2,3,4,9;15,20,21,22,23,24,19;14,13,12;6,7,8
5,0,35,5;24,19,14,13;4,3,2,1,0,5,10;6,11,16;9,8,7,12,17,18,23;15,20,21,22
5,0,36,5;8,13,18,23;15,10,5,0,1;24,19,14,9,4,3;16,11,6;2,7,12,17,22,21,20
5,0,37,6;12,7,6,5,0;3,2,1;16,17,18,13;11,10,15,20,21,22,23;8,9,4;24,19,14
5,0,38,4;23,18,13,12,7,2,3,4;0,5,10,15,20,21,22;1,6,11,16,17;24,19,14,9,8
5,0,39,4;0,1,6;16,17,18,13,8;15,20,21,22,23,24,19,14,9,4;3,2,7,12,11,10,5
5,0,40,4;0,1,2,3,8,13,18,17;4,9,14,19,24,23;20,15,10,5,6,7;22,21,16,11,12
5,0,41,5;20,21,22,23,24;7,8,13,18;3,4,9,14,19;17,16,15,10,5,0;12,11,6,1,2
5,0,42,5;16,17,18;5,0,1,2,7;9,14,19,24,23,22,21,20,15,10;13,12,11,6;8,3,4
5,0,43,3;14,13,12;9,4,3,2,1,0,5,10,15,20,21,22,23,24,19;18,17,16,11,6,7,8
5,0,44,5;4,9,8,7,12,11,16;10,5,0;14,19,24,23;6,1,2,3;13,18,17,22,21,20,15
5,0,45,4;16,17,12,13,14,19;22,21,20,15,10,5,0,1,2,3,4;18,23,24;9,8,7,6,11
5,0,46,4;12,11,10,5,0,1,2,3;18,13,8,7,6;20,15,16,17;21,22,23,24,19,14,9,4
5,0,47,6;4,9,14;24,19,18,13,8,3;0,1,6,11,16;2,7,12,17;23,22,21,20;15,10,5
5,0,48,5;4,9,8,13,18;15,20,21;6,7,12,17,22,23,24,19,14;16,11,10,5;3,2,1,0
5,0,49,5;24,23,18,17,12,11,6;13,8,7,2,1,0;16,15,10,5;3,4,9,14,19;22,21,20
5,0,50,4;16,17,18,19;24,23,22,21,20,15,10,11,12,13,14;8,7,6,5,0;9,4,3,2,1
5,0,51,4;4,9,14,19,18,17,12,7;6,11,16,21,22,23,24;13,8,3,2;1,0,5,10,15,20
5,0,52,5;24,19,18,13,8,3,2;11,10,5;4,9,14;15,16,17,12,7,6,1,0;23,22,21,20
5,0,53,6;19,18,17,12;24,23,22,21,16,11,6;20,15,10,5;9,14,13;8,3,4;7,2,1,0
5,0,54,5;6,11,12,13,8;24,23,18,17,16;19,14,9,4,3,2,7;22,21,20,15,10;5,0,1
5,0,55,4;8,7,6,5,10,15,16,17,18,23;11,12,13;0,1,2,3,4,9,14,19,24;22,21,20
5,0,56,5;10,5,0,1,2,3;19,14,9,4;8,7,6,11,16,15;20,21,22,17;12,13,18,23,24
5,0,57,4;17,16,11,10,5,0,1,2,3,8;15,20,21,22,23,18;24,19,14,9,4;13,12,7,6
5,0,58,5;11,16,17,18,13,8;9,4,3,2,1,0,5;12,7,6;23,24,19,14;10,15,20,21,22
5,0,59,5;4,3,2,1,0,5,10,11;19,14,13,12;22,21,20,15;6,7,8,9;16,17,18,23,24
5,0,60,5;12,17,16;5,0,1,2,3,8,13,18;4,9,14,19,24;23,22,21;20,15,10,11,6,7
5,0,1,4;24,23,18;15,20,21,22,17,12,13,14,19;8,7,6;9,4,3,2,1,0,5,10,11,16
5,0,2,4;11,6,7,8;24,19,14,9,4,3,2,1,0,5;16,17,12;10,15,20,21,22,23,18,13
5,0,3,4;8,13,18,17,16,15,20;7,2,3,4,9,14,19,24,23,22,21;12,11,6,1;10,5,0
5,0,4,4;5,0,1,2;4,3,8,13,18,17,16,11,10;6,7,12;9,14,19,24,23,22,21,20,15
5,0,5,4;16,17,12;15,20,21,22,23,18,13,8,7,6;24,19,14,9,4,3,2;1,0,5,10,11
5,0,6,4;5,0,1,2,3,4,9;8,13,18,17,16;12,7,6;14,19,24,23,22,21,20,15,10,11
5,0,7,4;21,16,11,6,5,0;18,13,8,3,2,1;4,9,14,19,24,23,22,17,12,7;10,15,20
5,0,8,4;1,0,5,10;16,17,18;8,13,12,11;15,20,21,22,23,24,19,14,9,4,3,2,7,6
5,0,9,5;0,1,2;11,12,13,18;4,9,14,19,24,23,22;20,21,16,17;15,10,5,6,7,8,3
5,0,10,4;12,11,10,5,0,1,2,3,4,9,14,19,24,23;15,20,21,22;18,17,16;13,8,7,6
5,0,11,4;16,17,18,13,14;0,5,10,15,20,21,22,23,24,19;4,3,2,1,6,11,12;7,8,9
5,0,12,4;8,13,18,17,16;1,2,7,12;6,5,0;11,10,15,20,21,22,23,24,19,14,9,4,3
5,0,13,4;7,8,9,14,19,18;21,20,15,10,5,0;16,17,22,23,24;13,12,11,6,1,2,3,4
5,0,14,5;7,6,11;24,19,18;8,3,2,1,0,5,10;4,9,14,13,12,17,16,15;20,21,22,23
5,0,15,4;22,23,24,19,14,9,4,3,2,1,0,5;8,7,6;20,15,10,11,12,13,18;21,16,17
5,0,16,4;17,12,7,8,3;4,9,14,13,18;16,11,6;19,24,23,22,21,20,15,10,5,0,1,2
5,0,17,5;5,10,15,20,21;0,1,6;16,17,18,13,8;22,23,24,19,14,9;4,3,2,7,12,11
5,0,18,3;6,11,16,17,18,13,8,3;4,9,14,19,24,23,22,21,20,15,10;12,7,2,1,0,5
5,0,19,3;6,11,16,17,18,13,8;4,3,2,7,12;1,0,5,10,15,20,21,22,23,24,19,14,9
5,0,20,4;21,22,23,24,19,14;20,15,16,17,18;13,12,11,10,5,0,1,2,3,4;9,8,7,6
5,0,21,4;17,22,23,24,19,14,9,4,3,2,1,0,5;10,15,20,21;16,11,12,13,18;8,7,6
5,0,22,5;3,4,9,14,19,24,23,22,21;1,2,7,8,13;0,5,6,11,12;20,15,10;18,17,16
5,0,23,4;18,17,16,11,6;13,12,7,2,1;9,14,19,24,23,22,21,20,15,10,5,0;4,3,8
5,0,24,4;0,1,6,7,8;5,10,11,12,13,18,23,22,21;24,19,14,9,4,3,2;20,15,16,17
5,0,25,4;18,13,8,3;1,6,11,16,21;20,15,10,5,0;2,7,12,17,22,23,24,19,14,9,4
5,0,26,5;0,1,2,3;18,17,16,11;22,21,20,15,10,5,6,7;4,9,8;12,13,14,19,24,23
5,0,27,5;10,15,20;22,21,16,11;17,12,7,6;18,13,8,3,2,1,0,5;4,9,14,19,24,23
5,0,28,5;18,23,24;7,2,1,0,5,10,15,20,21,22,17;12,13,8,3,4;19,14,9;6,11,16
5,0,29,4;22,21,16,11,6;20,15,10,5,0,1,2,3,8,13,18,23;24,19,14,9,4;7,12,17
5,0,30,4;15,20,21,22,23,24,19,14;1,0,5,10,11,12,13,8,9;16,17,18;4,3,2,7,6
5,0,1,5;0,5,10,15,20,21;2,1,6,11,16;7,12,17,22;4,3,8,13,18;9,14,19,24,23
5,0,2,4;17,22,21,20;12,11,16;24,23,18,13,8,7,6,5,10,15;19,14,9,4,3,2,1,0
5,0,3,5;8,13,12;3,4,9,14,19,24,23;20,21,16,11,6,7,2;15,10,5,0,1;18,17,22
5,0,4,4;3,2,1,0,5;4,9,8,7,6,11,10,15,20;21,16,17,18;22,23,24,19,14,13,12
5,0,5,4;3,2,1,0,5,10,15,20,21,22;4,9,8;19,14,13,12,7;6,11,16,17,18,23,24
5,0,6,4;19,18,17,12,7,8,3;4,9,14,13;2,1,6,11,16;0,5,10,15,20,21,22,23,24
5,0,7,4;18,17,16;12,11,6,5;0,1,2,7,8,13;3,4,9,14,19,24,23,22,21,20,15,10
5,0,8,5;16,11,6,1,2,3;19,24,23,22;0,5,10,15,20,21;12,7,8;17,18,13,14,9,4
5,0,9,4;22,23,24,19,14,9,4,3;8,13,18,17,16,21;7,2,1,0,5,10,15,20;6,11,12
5,0,10,4;11,6,7,8;5,0,1,2,3,4,9,14,19,24;12,17,16,15,10;20,21,22,23,18,13
5,0,11,4;24,19,14,9,4,3,2;12,17,16,15,20;0,5,10,11;21,22,23,18,13,8,7,6,1
5,0,12,5;3,2,1,0,5,10;4,9,8;16,11,6,7;24,23,18;15,20,21,22,17,12,13,14,19
5,0,13,5;10,15,20,21,22,23;18,17,16,11,6,5,0;13,14,19,24;3,2,1;12,7,8,9,4
5,0,14,5;24,23,18;2,1,0,5,10;19,14,9,4;3,8,7,6,11,16,15,20;21,22,17,12,13
5,0,15,4;20,15,10;7,8,13,18,17,16,21;12,11,6,5,0;1,2,3,4,9,14,19,24,23,22
5,0,16,4;17,18,19;8,7,6;10,15,20,21,22,23,24;5,0,1,2,3,4,9,14,13,12,11,16
5,0,17,4;0,1,2,3,4;7,12,11,16;8,13,18,17,22,21,20,15,10,5,6;9,14,19,24,23
5,0,18,4;20,15,10,5,0,1,2,3,4,9,14,13,18,17;19,24,23,22;12,7,8;21,16,11,6
5,0,19,4;5,0,1,2,3,4,9,14,19,24,23,22;15,10,11,12,13;6,7,8;18,17,16,21,20
5,0,20,4;17,16,11,6,1,0;12,7,2;4,9,14,19,24,23,22,21,20,15,10,5;3,8,13,18
5,0,21,5;7,8,13,18;6,11,12,17,22;20,21,16;9,4,3,2,1,0,5,10,15;23,24,19,14
5,0,22,5;10,5,0,1;24,23,22,21;12,13,8;20,15,16,11;6,7,2,3,4,9,14,19,18,17
5,0,23,4;10,15,20,21,22,17,18;8,7,6;5,0,1,2,3,4,9,14,13,12,11,16;23,24,19
5,0,24,4;0,1,2,3,4;21,20,15,10,5,6,7,8,9,14;24,23,22,17,16,11;12,13,18,19
5,0,25,5;4,3,2,1;0,5,6,7,8,9,14;18,17,16,21,20;19,24,23,22;15,10,11,12,13
5,0,26,4;6,7,8;24,23,22,17;15,10,5,0,1,2,3,4,9,14;20,21,16,11,12,13,18,19
5,0,27,4;6,7,8,3,4;24,23,22,21,20,15,10,5,0,1,2;13,12,11;9,14,19,18,17,16
5,0,28,5;6,7,8;18,17,22,21;23,24,19,14,13,12,11,16;20,15,10;5,0,1,2,3,4,9
5,0,29,5;6,7,8;0,1,2,3,4,9,14;18,17,16,15;19,24,23,22,21,20;5,10,11,12,13
5,0,30,4;11,16,21;20,15,10,5,6,7,12;17,18,13,8,3,2,1,0;22,23,24,19,14,9,4
5,0,1,4;9,4,3,2,1;7,6,5,0;16,17,18,19,14;8,13,12,11,10,15,20,21,22,23,24
5,0,2,4;0,5,10,15,20;18,13,8,3,4;17,12,7;9,14,19,24,23,22,21,16,11,6,1,2
5,0,3,4;20,21,22,23;24,19,14,9,4,3;18,17,12,11,6;13,8,7,2,1,0,5,10,15,16
5,0,4,5;4,9,14,13;19,24,23,22,21,16;6,7,8,3;11,12,17,18;20,15,10,5,0,1,2
5,0,5,5;23,18,13;15,20,21,22,17,12;2,1,0,5,10;3,4,9,14,19,24;8,7,6,11,16
5,0,6,5;8,13,18;5,6,11,12,17;20,15,10;0,1,2,7;16,21,22,23,24,19,14,9,4,3
5,0,7,4;24,23,22,21,20,15,10,5,0,1;8,13,12;6,7,2,3,4,9,14,19;18,17,16,11
5,0,8,3;15,10,5,0,1,2,3,4,9,14,19;20,21,16,11,6,7,8,13,18;24,23,22,17,12
5,0,9,4;8,13,18,17,16,11,10,5;9,14,19,24,23,22,21,20,15;12,7,6;0,1,2,3,4
5,0,10,4;2,1,0,5,10,15,20,21;12,17,22,23,24,19,14,9,4,3;6,11,16;18,13,8,7
5,0,11,3;3,4,9,14,19,24,23,22,21,20,15,10,5;12,11,6,1,0;2,7,8,13,18,17,16
5,0,12,4;16,17,18;19,24,23,22,21,20,15,10,11,12,13;4,3,2,1;14,9,8,7,6,5,0
5,0,13,4;15,10,11,6;8,13,18,23,22;24,19,14,9,4,3,2,7,12,17,16,21,20;5,0,1
5,0,14,4;23,22,21,20,15,10,11,12,13,14,9;16,17,18,19,24;8,7,6;4,3,2,1,0,5
5,0,15,4;24,23,22,21,20,15,10,5,0,1,2,3,4;11,12,13;19,18,17,16;6,7,8,9,14
5,0,16,4;6,7,2,3;18,17,16;4,9,14,19,24,23,22,21,20,15,10,5,0,1;8,13,12,11
5,0,17,4;15,10,5,0,1,2,3,4,9,14,13;16,11,6,7,8;19,24,23,22,21,20;18,17,12
5,0,18,4;23,18,13,8;24,19,14,9,4,3,2,1;10,15,20,21,22,17,12,7;0,5,6,11,16
5,0,19,5;21,22,17,12,7;6,11,16,15,20;19,14,9,4,3,2;1,0,5,10;8,13,18,23,24
5,0,20,4;18,13,8,3,4;9,14,19,24,23,22,21,20;1,2,7,12,17,16,15,10;0,5,6,11
5,0,21,4;15,10,5,0,1,2,3,4,9,14;6,7,8,13,18;20,21,16;19,24,23,22,17,12,11
5,0,22,4;23,24,19,14,9,4,3,2;5,10,15,20,21,22,17,18,13,8;16,11,12;7,6,1,0
5,0,23,4;6,7,12,17;8,13,18;15,20,21,22,23,24,19,14,9,4,3,2,1,0;16,11,10,5
5,0,24,5;1,6,7,12,17,22,21;24,23,18,13,8,3,2;19,14,9,4;0,5,10;20,15,16,11
5,0,25,3;19,18,17,16,11,6,7,8,3,4;24,23,22,21,20,15,10,5,0,1,2;9,14,13,12
5,0,26,5;14,9,4,3,2;24,23,22,21,20,15;6,7,8,13;1,0,5,10,11,16;12,17,18,19
5,0,27,4;6,11,16;22,21,20,15,10,5,0,1;18,13,8;17,12,7,2,3,4,9,14,19,24,23
5,0,28,6;8,13,18;16,11,6;21,20,15,10;7,12,17;3,4,9,14,19,24,23,22;5,0,1,2
5,0,29,4;2,3,4,9;13,14,19,24,23,22,21,20,15,10,5,0,1;16,11,6;18,17,12,7,8
5,0,30,3;1,0,5,10,11,12;2,3,4,9,14,19,24,23,22,21;6,7,8,13,18,17,16,15,20
5,0,31,3;1,0,5,10,15,20,21,22,23,24,19,14,9,4;6,11,16,17,18,13,8,3;12,7,2
5,0,32,5;2,3,4,9,14,19,24,23,22;21,20,15,10,5,0;1,6,7,8;18,17,16;11,12,13
5,0,33,4;0,1,6;13,18,17,16;8,9,14,19,24,23,22,21,20,15;5,10,11,12,7,2,3,4
5,0,34,5;0,1,6;18,17,16;11,12,7,2,3;13,14,19,24,23,22,21,20,15,10,5;8,9,4
5,0,35,5;10,15,20,21,22,23,24,19,14,9;8,7,12;0,5,6,11,16;4,3,2,1;17,18,13
5,0,36,3;20,21,22,23,24,19,14,9,4,3;1,6,11,12;0,5,10,15,16,17,18,13,8,7,2
5,0,37,5;20,15,10;5,0,1,2,3,4,9,14,19,24,23;17,22,21;12,11,16;6,7,8,13,18
5,0,38,4;22,23,24,19,14,13,8;9,4,3,2,1,0,5,10,15;6,11,16,21,20;18,17,12,7
5,0,39,4;24,23,22,21,20;18,17,12,11,6,1,2,3,4,9;16,15,10,5,0;7,8,13,14,19
5,0,40,3;0,5,10,15,20,21,22,23,24,19,14;4,3,2,1,6,11,16,17,18,13;9,8,7,12
5,0,41,5;23,22,17;21,16,11,6;18,19,24;4,9,14,13,12,7;20,15,10,5,0,1,2,3,8
5,0,42,5;5,6,11,16,17;24,23,22,21,20,15,10;12,7,2,1,0;3,4,9,14;19,18,13,8
5,0,43,4;23,22,21,20;0,1,2,3,4,9,14,13;24,19,18,17,12,11;16,15,10,5,6,7,8
5,0,44,3;15,10,11,12,17,22,23,24,19,14,9,4,3,2,1,0;16,21,20;18,13,8,7,6,5
5,0,45,4;3,2,1;11,16,17,18,13,8,9,4;0,5,10,15,20,21,22,23,24,19,14;6,7,12
5,0,46,4;19,14,9,4,3,2,1,0,5,10,15,20;7,8,13;22,21,16;6,11,12,17,18,23,24
5,0,47,4;8,13,18;16,11,6,1,0;2,3,4,9,14,19,24,23;7,12,17,22,21,20,15,10,5
5,0,48,3;7,6,11,16,17,18,19,14;12,13,8;9,4,3,2,1,0,5,10,15,20,21,22,23,24
5,0,49,4;0,1,6;12,11,10,5;2,7,8,13,18,17,16;3,4,9,14,19,24,23,22,21,20,15
5,0,50,4;15,10,5,0,1,2,7,12,17,22;23,18,13,8;6,11,16,21,20;24,19,14,9,4,3
5,0,51,5;21,20,15;6,7,8,3;24,19,18,13,12,11,10,5,0,1,2;23,22,17,16;4,9,14
5,0,52,5;5,10,11;18,13,8,7,6,1,0;20,15,16,17,12;21,22,23,24;19,14,9,4,3,2
5,0,53,4;3,8,13,12;24,23,18,17,16,11,6,7,2;22,21,20,15,10,5,0,1;4,9,14,19
5,0,54,5;4,3,2;14,19,24,23,22,21,20,15;5,10,11,12,13;16,17,18;0,1,6,7,8,9
5,0,55,5;4,3,8,7,6,5;9,14,19,24,23,22;0,1,2;16,17,18,13;21,20,15,10,11,12
5,0,56,5;3,8,7,6,11,16,21;13,12,17,22,23;24,19,18;14,9,4;2,1,0,5,10,15,20
5,0,57,4;16,17,18;10,5,0,1,2,3,4,9;15,20,21,22,23,24,19,14,13,12,11;8,7,6
5,0,58,4;19,18,13,12,11,10,15,20,21;14,9,8,7,6,5;4,3,2,1,0;16,17,22,23,24
5,0,59,5;1,2,7,8;0,5,6,11,12,13,14,19,24,23,22;18,17,16,21;3,4,9;20,15,10
5,0,60,5;1,0,5,10,15,20,21,22,17;2,7,6,11,16;24,23,18;12,13,8,3;19,14,9,4
5,0,1,5,12,0:4:20:24;2,7,12,17;1,6,5;3,8,9;10,11,12,13,14;15,16,21,22,23,18,19
5,0,2,4,6;21,20,15,10;12,13,18;0,5,6,7,8,9,14,19,24,23,22,17,16;11,6,1,2,3,4
5,0,3,3,8;2,1,6,11,16,17,18;0,5,10,15,20,21,22,23,24,19,14,13,8,3;12,7,8,9,4
5,0,4,5,11;15,20,21,22;4,3,2,1,0,5,10,11,12,13;17,18,23;9,8,7,6,11,16;24,19,14
5,0,5,4,6;10,15,20,21;1,6,11,12,13,18;8,7,6,5,0;16,17,22,23,24,19,14,9,4,3,2
5,0,6,4,7;20,15,10,5,0,1,2,7,12,17,22;21,16,11,6,7,8;19,14,9,4,3;13,18,23,24
5,0,7,5,16;20,21,16,11,12,13,8,3,2,1,0;7,6,5;22,23,24;14,9,4;10,15,16,17,18,19
5,0,8,3,17;19,14,13;4,9,8,7,6,11,16,17,18,23,24;3,2,1,0,5,10,15,20,21,22,17,12
5,0,9,4,8;13,8,3,4;14,19,18,17,12;24,23,22,21,20,15,10,5,0,1,2;9,8,7,6,11,16
5,0,10,3,11;4,3,8,13,18,17,16,11,6;5,0,1,2,7;9,14,19,24,23,22,21,20,15,10,11,12
5,0,11,4,16;0,1,2,7;10,5,6;9,14,19,24,23,22,21,16,11,12;4,3,8,13,18,17,16,15,20
5,0,12,5,18;23,18,13,8;12,7,6;15,20,21,22,17,18,19,24;2,1,0,5,10,11,16;14,9,4,3
5,0,13,4,11;23,18,17;24,19,14,13,12,11,10,5,0,1,2,3;16,11,6,7,8,9,4;15,20,21,22
5,0,14,5,8;20,15,10;5,6,7,8,9,4;12,17,18,23;11,16,21,22;24,19,14,13,8,3,2,1,0
5,0,15,3,13;19,24,23,22,21,20;11,6,7,8,13,18,17;16,15,10,5,0,1,2,3,4,9,14,13,12
5,0,16,4,13;8,13,18,19,24;1,0,5,10,15,20,21;16,11,6,7,2,3,4;23,22,17,12,13,14,9
5,0,17,3,17;8,7,6,11,16,17,18,19;24,23,22,17,12,13,14,9;21,20,15,10,5,0,1,2,3,4
5,0,18,3,13;15,10,5,0,1,2,3,4,9,14,13,12,17;16,11,6,7,8,13,18;19,24,23,22,21,20
5,0,19,5,6;16,17,12,7,6,5;0,1,6,11,10,15;4,3,2;20,21,22,23,24,19,14;18,13,8,9
5,0,20,4,6;24,19,14;17,16,15,10;20,21,22,23,18,13,12,11,6,1,2,3;0,5,6,7,8,9,4
5,0,21,5,12;10,5,0;24,23,22,21,20;7,12,17,18,19,14;6,1,2,3;4,9,8,13,12,11,16,15
5,0,22,4,12;2,3,4,9,14,19,24,23,22,21,16;7,12,17,18;20,15,10,5;0,1,6,11,12,13,8
5,0,23,4,17;2,1,0,5,10,15,20,21;13,14,9;24,23,22,17,12;19,18,17,16,11,6,7,8,3,4
5,0,24,4,12;4,9,14,19,18;24,23,22,21,20,15,10;5,6,7,12,17,16;0,1,2,3,8,13,12,11
5,0,25,5,16;6,11,16,21,20;9,4,3,2,1,0,5,10;15,16,17,18,13;22,23,24,19,14;8,7,12
5,0,26,5,8;12,17,18,23;24,19,14,13,8,3,4;6,11,16,21,22;9,8,7,2,1,0,5;10,15,20
5,0,27,5,6;20,15,10;21,16,17;8,7,6,5,0;4,3,2,1,6,11,12,13,18;22,23,24,19,14,9
5,0,28,4,6;20,15,10,5,6,7,8;19,24,23,22,17,12;0,1,6,11,16,21;2,3,4,9,14,13,18
5,0,29,5,18;4,3,2,1,6,11,16,15,20;7,8,9,14;24,19,18,17,22,21;12,13,18,23;10,5,0
5,0,30,4,12;8,13,12,11,6,1,0;5,10,15,20,21,22,23,18;16,17,12,7;2,3,4,9,14,19,24
5,0,1,5;22,17,12,7,2;1,6,11,16;3,8,13,18;21,20,15,10,5,0;4,9,14,19,24,23
5,0,2,5;17,12,7,2,3,4;14,19,24,23;20,15,10,5,0;9,8,13,18;22,21,16,11,6,1
5,0,3,5;0,1,2,3;4,9,8,7,6,5;22,23,24;19,18,17,16,21;14,13,12,11,10,15,20
5,0,4,5;11,6,7,8,3;20,15,16,17,18,19,24;21,22,23;2,1,0,5,10;12,13,14,9,4
5,0,1,5;21,16,11,6,7;18,17,12;20,15,10,5,0,1,2;9,14,19,24,23,22;4,3,8,13
5,0,2,4;12,17,18,19,24;20,21,22,23;9,4,3,2,1,0,5,10,15;16,11,6,7,8,13,14
5,0,3,4;0,1,2,7,8;13,18,17,16;3,4,9,14,19,24,23,22,21,20,15,10,5;6,11,12
5,0,4,4;19,24,23,22,21,20;18,17,16,15,10,5,6,7,8;13,12,11;0,1,2,3,4,9,14
5,0,5,4;12,13,8,3,2;19,14,9,4;7,6,11,16,17,18;1,0,5,10,15,20,21,22,23,24
5,0,6,4;0,1,2,3,4,9,14,19,18;24,23,22,17,16;21,20,15,10,5,6,7,8;11,12,13
5,0,7,4;20,21,22,17,18,13,8;1,0,5,10;12,11,16,15;23,24,19,14,9,4,3,2,7,6
5,0,8,4;4,9,14,19,24,23,22;20,15,10,11,12,7;0,5,6;1,2,3,8,13,18,17,16,21
5,0,9,3;4,9,14,19,18,17,16,11,6,7;8,13,12;24,23,22,21,20,15,10,5,0,1,2,3
5,0,10,5;13,12,11;21,22,23,24;19,18,17,16,15,20;8,7,6;10,5,0,1,2,3,4,9,14
5,0,11,6;11,16,21;22,17,12,7,6;24,19,14,9,4,3;2,1,0,5;23,18,13,8;10,15,20
5,0,12,5;24,23,22,21,20,15,10;5,6,7,12;0,1,2,3,4,9;18,17,16,11;8,13,14,19
5,0,13,5;12,13,14,19;1,6,7,8;0,5,10,15,20,21,22;9,4,3,2;24,23,18,17,16,11
5,0,14,5;20,21,22;6,11,16,17,18,23;9,8,7,12;24,19,14,13;4,3,2,1,0,5,10,15
5,0,15,5;21,22,17,12;11,10,5,0;2,3,4,9,14,19;20,15,16;1,6,7,8,13,18,23,24
5,0,16,4;8,7,6,5,10,15,20,21;23,22,17,16;0,1,2,3,4,9,14;24,19,18,13,12,11
5,0,17,4;9,8,7,6,5,10,15,20,21,22;4,3,2,1,0;23,24,19,14,13,12,11;16,17,18
5,0,18,5;24,19,18,13,8;17,12,7;1,6,11,16;2,3,4,9,14;23,22,21,20,15,10,5,0
5,0,19,5;5,10,15,20,21,22,23,24,19,14;0,1,6,11;13,8,9,4;3,2,7,12;16,17,18
5,0,20,4;0,1,6;16,11,12,7,2,3,4,9,14,19,24,23;8,13,18,17;22,21,20,15,10,5
5,0,21,5;18,17,16,11,6;1,0,5,10,15;4,3,2,7,12,13;23,22,21,20;24,19,14,9,8
5,0,22,5;16,21,20;5,0,1,2;15,10,11,6,7,8,3;19,24,23,22,17,12;4,9,14,13,18
5,0,23,4;22,23,24,19,14,9,4,3,2,7,12,11;5,10,15,20;21,16,17,18,13,8;6,1,0
5,0,24,4;2,3,4,9,14,19,24,23,22,21,16,11,12;8,13,18,17;20,15,10,5,0;1,6,7
5,0,25,5;6,7,8;5,0,1,2,3,4,9,14,19,24,23;18,17,22;21,20,15,10;16,11,12,13
5,0,26,4;15,16,17,18,19,14,9,4;1,2,3,8,13,12,11,10;7,6,5,0;20,21,22,23,24
5,0,27,4;4,9,14,19,24,23,22,21;6,7,2;12,11,10,5,0,1;3,8,13,18,17,16,15,20
5,0,28,4;4,3,2,1,0,5,10,15,20;13,18,19,24;21,16,11,6;23,22,17,12,7,8,9,14
5,0,29,5;9,14,19,24;20,21,22,17,12;0,5,10,15,16;4,3,2,1;23,18,13,8,7,6,11
5,0,30,3;24,23,18,13,8,7,6,11,16,21,20;12,17,22;15,10,5,0,1,2,3,4,9,14,19